1111111111111111111111111111111111
100000000000000C00000C0000000000P1
1000000000000000100000000111111111
1010010100100001000001000000010001
1101010101010101010101010101010101
1010010000101010000010000000000E11
100000000C00C1000100000000000000C1
1111111111111111111111111111111111
1111111111111111111111111111111111 