1111111111111111111111
100C100C100C100C000001
11100C10PC100C100EC111
1111111111111111111111