111111111111
1000000000C1
100001110001
100011000001
1P011E000001
111111111111