1111111111
1YYYPYYYE1
1YYYYYYY01
1Y0X0X0Y01
1Y0Y0Y0Y01
1Y0X0X0Y01
1X0Y000Y01
1YYY000Y01
1CYY000001
1111111111