11111111
1C100001
1YY10001
10Y01011
1PE11111
11111111
11111111
11111111