11111111
1PC000E1
1YY10001
1Y011011
1Y011011
10000C11
10111111
10000001
1YY10001
1Y011011
1Y011011
10000C11
11111111