11111111
1C110111
1YY10001
1Y011111
1Y011111
10P00011
1E111111
11111111