11111111
1C000001
1Y010001
10Y01011
1PE01111
11111111
11111111
11111111