1111111111
1P0Y0000E1
1X0Y000Y01
1Y0X0X0Y01
1Y0Y0Y0Y01
1Y0X0X0Y01
1X0Y000Y01
1Y0Y000Y01
1C00000001
1111111111