11111111
1C110111
1YY10001
1Y011011
1Y011011
10P00C11
1E111111
11111111