1111111111111111111111111111111111
1E000YY00000000C00000C000000000001
1010010100100000101001000000010101
1010010010101010001001000000010101
1PYY00000C00CYYYYYYYYYYYYYYYYYYYC1
1111111111111111111111111111111111