1111111111111
100C00C0CCE01
1YPYYYYYYYYY1
1YYYYYYYYYYY1
1111111111111