1111111111111
1P0C00C0Y0C01
1YY0010C0Y001
1C0110C0Y0C01
1C0010C001E11
1C0110C0Y0C01
1YY0010C0Y0C1
1C0110C0Y0001
1111101100011
1111111111111