1111111111111111
1P0Y0Y0Y0Y0Y0Y01
1X000000X0X0X0X1
1Y0Y0Y0Y000Y0Y01
1C0X0X0X0X0X0X01
1Y0Y0Y0Y0Y000Y01
1X0X0X0X0X0X0X01
1Y0000000000Y001
1C0Y0Y0Y0Y0Y0Y01
1X0X0X0X0X0X0X01
1Y0Y0Y0Y0Y0Y0Y01
1X0X0X0X0X0X0X01
1E0Y0Y0Y0Y0Y0Y01
1111111111111111
