11111111111
1P0Y00000E1
1X0C0X0C001
1Y0000Y0Y01
1C0X000X001
1Y0000Y0Y01
1X0C0X0C001
1Y0000Y0Y01
1C0X0X0X001
11111111111