1111111111111
10C00000000C1
10X001000C001
1PXC01E000001
1111111111111
1101101000111
1101101111011
1110001000011
1111101011111
1111100100011
1111111111111
1111111111111