1111111111111
1P00C0X000C01
1YY000100Y0C1
1C010C0Y0X001
111110110E011
1C0Y0C010Y0C1
10C0Y0C0Y00C1
1111101100C11
1C0X00C0Y0C01
1111111111111