111111111111
111110X11111
11111X011111
111110X11111
11111X011111
111110X11111
11111X011111
111110X11111
11111X011111
111110X11111
11111X011111
100000X00001
11111XX11111
11111X011111
11111XP11111
111110011111
10000CC000E1
111111111111