111111111111
111111XC1111
111111X11111
111111X11111
111111X11111
111111XC1111
111111X11111
111111X11111
111111X11111
111111X11111
11Y001XCY001
111111X11111
111111X11111
111111X11111
111110PX0111
1Y00YCY00EY1
111111111111