111111111111
111110011111
111110011111
111110011111
111110011111
111110011111
111110011111
111110011111
111110011111
111110011111
111110011111
100000000001
111110011111
111110011111
111110011111
111111111111
1P000CC000E1
111111111111