111111111111
111111111111
100000001101
100001100001
100011001001
111111111111
11P110000111
100000CEC011
111111111111
111111111111
111111111111
111111111111
111111111111
111111111111
111111111111
111111111111
111111111111
111111111111
111111111111
111111111111
111111111111
111111111111
