1111111111111
10010000C0001
1000011110011
1P001110EC0C1
1111111111111
1111111111111
1111111111111
1111111111111
1111111111111
1111111111111