1111111111111111111
1E000000C0000001111
1001011111000001111
10110000C0000P01111
10110000000000Y1111
1C10111110110XXXC11
1111111111111111111