11111111111111111111111111
10C10Y00Y00C0Y0C100XX000C1
10X0YX1XXXC101100Y010Y0C01
1P0C01E0000Y011C0C01C00001
11111111111111111111111111
11111111111111111111111111
11111010000100001000011111
11110011110111101111011111
11101011110111101111011111
11111010000100001000011111
11111011110111101111011111
11111011110111101111011111
11111010000100001111011111
11111111111111111111111111