1111111111111
1P0000C0C0001
1YY0010C0Y0C1
1C0110C0Y0001
1111101100E11
1C0Y0C0Y001C1
10C0Y0C001C01
1111101100011
1111111111111