111111
1P0E11
1Y00C1
1Y0Y01
1Y0YC1
1Y0C01
111111