111111111111
1111XC110XC1
1111X111X111
1111X111X111
1111X111X011
1111XC111X11
1111X1111X11
1111X1111X11
1111X1111X11
1111X1111X11
11Y0Y0XCY0Y1
1111X1111X11
1111X1111X11
1111X1111X11
11110PX00011
1Y00YCY00EY1
111111111111